80
11
00000000000000000000000050000000000000000050000000000000000000000000000000000000
06000000000000000000000000000000000000000222200000000000000000000005000000050007
44400000000004444000000050000000000000000000000000000000000000000000000000000444
88400500050004884000000000000000000000000000000000000000000000000000000000000488
88444444444444884444444444444440004444444444444444444400004444444400044444444488
88888888888888888888888888888840004888888888888888888400004888888433348888888888
88888888888888888888888888888843334888888888888888888433334888888433348888888888
88888888888888888888888888888843334888888888888888888433334888888433348888888888
88888888888888888888888888888844444888888888888888888444444888888444448888888888
88888888888888888888888888888888888888888888888888888888888888888888888888888888
88888888888888888888888888888888888888888888888888888888888888888888888888888888