80
32
88888888888888888888888888888888888888888888888888888888888888888888888888888888
88888888888888888888888888888888888888888888888888888888888888888888888888888888
88844444444444444444444444444444444888888888888888888888888888888888888888888888
88840000000000000000000000000000004444444444444444444444444444444444444444448888
88840000000000000000000000000000000000000000000000000000000000000000000000044888
88840000000000000000000000000000000000000000000000000000000000000000000000004888
88840000000000000000000000000000000000000000000000000000000000000000000000004888
88840000500000000000500000000000000000000000000005005000000000000000000005004888
44440500000000444444444444444400000000000000000000000000000000000000000000004888
00000000500000000000000000000444444444400000444444444444444444400004444444444888
60000000000000000000000000000000000000433333400000000000000000400004888888888888
44444444444444444400005500000005050500444444404444444444444440400004888888888888
88888400000000000000050050000000000000400000004000000400000000400004888888888888
88888400000000000000000000444444444444400444444044440404444444400004444444488888
88888400000000000004444444400000000000000400000000000404000000000000000000488888
88888400000000004444000000444400044444444444444444444404000000000000000000488888
88888400000000444000000000000444000000000000000000000004444444400004444444488888
88888400000004400000000000000004444444444444444444444444000000400004888888888888
88888400000004000000000000000000000000000000000000000000000000400004888888888888
88888444000000000005000000000000000000000000000000000000000000400004888888888888
88888884000000000022200000000000000000000000000000000000000000000004888888888888
88888884000000000000000500000000000000000000000000000005000000000004888888888888
88888884444444440000004440000044444444444400000000000000000000000004888888888888
88888888888884000000000000000000488888888444440000444444405000000004444444448888
88888888888884333333333333333333488888888888840000488888400000000000000000048888
88888888888884333333333333333333488888888884440000444888444405000000000000048888
88888888888884444444444444444444488888888884000000004888888400000000000000044444
88888888888888888888888888888888888888888884333333334888888444400000000000000000
88888888888888888888888888888888888888888884333333334888888888400000000000000007
88888888888888888888888888888888888888888884333333334888888888444444444444444444
88888888888888888888888888888888888888888884444444444888888888888888888888888888
88888888888888888888888888888888888888888888888888888888888888888888888888888888

